"filename", "language", "Java", "comment", "blank", "total"
"i:\Users\timtr\Documents\GitHub\GSWT-Platformer\src\BackEnd\Control.java", "Java", 114, 6, 53, 173
"i:\Users\timtr\Documents\GitHub\GSWT-Platformer\src\BackEnd\HitBox.java", "Java", 49, 0, 18, 67
"i:\Users\timtr\Documents\GitHub\GSWT-Platformer\src\BackEnd\KeyLis.java", "Java", 28, 0, 8, 36
"i:\Users\timtr\Documents\GitHub\GSWT-Platformer\src\BackEnd\Map.java", "Java", 61, 0, 18, 79
"i:\Users\timtr\Documents\GitHub\GSWT-Platformer\src\BackEnd\Player.java", "Java", 58, 0, 28, 86
"i:\Users\timtr\Documents\GitHub\GSWT-Platformer\src\BackEnd\Rect.java", "Java", 35, 0, 13, 48
"i:\Users\timtr\Documents\GitHub\GSWT-Platformer\src\BackEnd\SoundPlayer.java", "Java", 49, 0, 14, 63
"i:\Users\timtr\Documents\GitHub\GSWT-Platformer\src\BackEnd\Test.java", "Java", 26, 1, 13, 40
"i:\Users\timtr\Documents\GitHub\GSWT-Platformer\src\BackEnd\Texture.java", "Java", 3, 0, 2, 5
"i:\Users\timtr\Documents\GitHub\GSWT-Platformer\src\FrontEnd\GUI.java", "Java", 71, 17, 36, 124
"i:\Users\timtr\Documents\GitHub\GSWT-Platformer\src\FrontEnd\Sprite.java", "Java", 21, 0, 10, 31
"i:\Users\timtr\Documents\GitHub\GSWT-Platformer\src\FrontEnd\Tile.java", "Java", 32, 2, 13, 47
"Total", "-", 547, 26, 226, 799